Look|Info|g(k)
View|Info|g(v)
View Building|Info|g(t)
Set Prefs|Info|g(q)
Info
|
Dig|Designations|g(dd)
Fell Trees|Designations|g(dt)
Gather Plants|Designations|g(dp)
Smooth|Carve|g(ds)
Engrave|Carve|g(de)
Carve Fort|Carve|g(da)
Carve|Designations
Up|Stairs|g(du)
Down|Stairs|g(dj)
Up/Down|Stairs|g(di)
Ramp|Stairs|g(dr)
Remove|Stairs|g(dz)
Stairs|Designations
Channel|Designations|g(dh)
Remove Designation|Designations|g(dx)
Remove Construction|Designations|g(dn)
Remove Building|Designations|g(qx)
Designations
Armor Stand|Furniture|g(ba)
Bed|Furniture|g(bb)
Seat|Furniture|g(bc)
Burial Receptacle|Furniture|g(bn)
Cabinet|Furniture|g(bf)
Container|Furniture|g(bh)
Weapon Rack|Furniture|g(br)
Statue|Furniture|g(bs)
Slab|Furniture|g(b!s)
Table|Furniture|g(bt)
Archery Target|Furniture|g(bA)
Traction Bench|Furniture|g(bR)
Nest Box|Furniture|g(bN)
Hive|Furniture|g(b!h)
Furniture|Buildings
Wall Grate|Constructions|g(bW)
Floor Grate|Constructions|g(bG)
Vertical Bars|Constructions|g(bB)
Floor Bars|Constructions|g(b!b)
Paved Road|Constructions|g(bo)
Dirt Road|Constructions|g(bO)
Glass Window|Constructions|g(by)
Gem Window|Constructions|g(bY)
Wall|Structures|g(bCw)
Floor|Structures|g(bCf)
Ramp|Structures|g(bCr)
Up Stair|Structures|g(bCu)
Down Stair|Structures|g(bCd)
Up/Down Stair|Structures|g(bCx)
Fortification|Structures|g(bCF)
Track|Structures|g(bCT)
Track Stop|Structures|g(bCS)
Structures|Constructions
Constructions|Buildings
Kennels|Workshops|g(bk)
Farm Plot|Workshops|g(bp)
Leather Works|Workshops|g(bwe)
Quern|Workshops|g(bwq)
Millstone|Workshops|g(bwM)
Loom|Workshops|g(bwo)
Clothier's Shop|Workshops|g(bwk)
Bowyer's Workshop|Workshops|g(bwb)
Carpenter's Workshop|Workshops|g(bwc)
Metalsmith's Forge|Workshops|g(bwf)
Jeweler's Workshop|Workshops|g(bwj)
Mason's Workshop|Workshops|g(bwm)
Butcher's Shop|Workshops|g(bwu)
Tanner's Shop|Workshops|g(bwn)
Craftsdwarf's Workshop|Workshops|g(bwr)
Siege Workshop|Workshops|g(bws)
Mechanic's Workshop|Workshops|g(bwt)
Still|Workshops|g(bwl)
Farmer's Workshop|Workshops|g(bww)
Kitchen|Workshops|g(bwz)
Fishery|Workshops|g(bwh)
Ashery|Workshops|g(bwy)
Dyer's Shop|Workshops|g(bwd)
Soap Maker's Workshop|Workshops|g(bwS)
Screw Press|Workshops|g(bwp)
Wood Furnace|Workshops|g(bew)
Smelter|Workshops|g(bes)
Glass Furnace|Workshops|g(beg)
Kiln|Workshops|g(bek)
Trade Depot|Workshops|g(bD)
Workshops|Buildings
Door|Mechanisms|g(bd)
Floodgate|Mechanisms|g(bx)
Floor Hatch|Mechanisms|g(bH)
Bridge|Mechanisms|g(bg)
Well|Mechanisms|g(bl)
Ballista|Mechanisms|g(bib)
Catapult|Mechanisms|g(bic)
Stone-Fall Trap|TrapsMachines|g(bTs)
Weapon Trap|TrapsMachines|g(bTw)
Lever|TrapsMachines|g(bTl)
Pressure Plate|TrapsMachines|g(bTp)
Cage Trap|TrapsMachines|g(bTc)
Upright Spear/Spike|TrapsMachines|g(bTS)
Screw Pump|TrapsMachines|g(bMs)
Water Wheel|TrapsMachines|g(bMw)
Windmill|TrapsMachines|g(bMm)
Gear Assembly|TrapsMachines|g(bMg)
Horizontal Axle|TrapsMachines|g(bMh)
Vertical Axle|TrapsMachines|g(bMv)
Roller|TrapsMachines|g(bMr)
Support|TrapsMachines|g(bS)
Animal Trap|TrapsMachines|g(bm)
Restraint|TrapsMachines|g(bv)
Cage|TrapsMachines|g(bj)
Traps/Machines|Mechanisms
Mechanisms|Buildings
Buildings
Animal|Stockpiles|g(pa)
Food|Stockpiles|g(pf)
Furniture|Stockpiles|g(pu)
Corpses|Stockpiles|g(py)
Refuse|Stockpiles|g(pr)
Stone|Stockpiles|g(ps)
Wood|Stockpiles|g(pw)
Gem|Stockpiles|g(pe)
Bar/Block|Stockpiles|g(pb)
Cloth|Stockpiles|g(ph)
Leather|Stockpiles|g(pl)
Ammo|Stockpiles|g(pz)
Coins|Stockpiles|g(pn)
Finished Goods|Stockpiles|g(pg)
Weapons|Stockpiles|g(pp)
Armor|Stockpiles|g(pd)
Custom|Stockpiles|g(pc)
Custom Settings|Stockpiles|g(pt)
Remove Stockpiles|Stockpiles|g(px)
Stockpiles
|
Prospect|DFHack|a(prospect)
Clean All|DFHack|a(clean all)
Confiscate Junk|DFHack|a(cleanowned scattered)
Vein Dig|DFHack|a(digvx)
Stonesense|DFHack|a(stonesense)
DFHack
|
Refresh Script||l
Exit Script||s